
[Strings]
KEY_OPTIONAL = "SOFTWARE\Microsoft\Windows\CurrentVersion\Setup\OptionalComponents"
@*:IJK = "Internet Jumpstart Kit"
@*:IE_TIP = "World Wide Web Internet Browser"
HISTORY = "histórico"
CACHE = "cache"
LONG_INET_PROGRAMS = "Arquivos de programas\Plus!\Microsoft Internet"
DOCS_DIR = "docs"
INET_DESC = "Acessórios\Ferramentas da Internet"
IEXPLORE_SHORT_DESC = "IEXPLORE"
IEXPLORE_DESC = "Internet Explorer"
URLHTTP = "URL:protocolo HTTP"
URLHTTPS= "URL:protocolo HTTP confidencial"
URLFTP  = "URL:protocolo FTP"
URLTELNET = "URL:protocolo Telnet"
URLRLOGIN = "URL:protocolo RLogin"
URLTN3270 = "URL:protocolo TN3270"
URLGOPHER = "URL:protocolo Gopher"
URLMAILTO = "URL:protocolo MailTo"
URLNEWS   = "URL:protocolo News"
URLFILE   = "URL:protocolo File"
THENET    = "Internet Explorer"
IDHTML    = "Documento de Internet (HTML)"
AUSOUND   = "Som no formato AU"
AIFF      = "Som no formato AIFF"
XBM       = "Imagem no formato XBM"
GIF       = "Imagem no formato GIF"
JPEG      = "Imagem no formato JPEG"
ISHORTCUT = "Atalho da Internet"

WWW_MSN_COM  = "http://www.msn.com.br"
WWW_ALLINONE = "http://www.msn.com.br"
