
[Strings]
KEY_OPTIONAL = "SOFTWARE\Microsoft\Windows\CurrentVersion\Setup\OptionalComponents"
@*:IJK = "Internet Jumpstart Kit"
@*:IE_TIP = "World Wide Web Internet Browser"
HISTORY = "history"
CACHE = "cache"
LONG_INET_PROGRAMS = "Program Files\Plus!\Microsoft Internet"
DOCS_DIR = "docs"
INET_DESC = "보조프로그램\인터넷 도구"
IEXPLORE_SHORT_DESC = "IEXPLORE"
IEXPLORE_DESC = "Internet Explorer"
URLHTTP = "URL:하이퍼텍스트 전송 프로토콜"
URLHTTPS= "URL:하이퍼텍스트 전송 프로토콜 (with Privacy)"
URLFTP  = "URL:파일 전송 프로토콜"
URLTELNET = "URL:텔넷 프로토콜"
URLRLOGIN = "URL:RLogin 프로토콜"
URLTN3270 = "URL:TN3270 프로토콜"
URLGOPHER = "URL:Gopher 프로토콜"
URLMAILTO = "URL:MailTo 프로토콜"
URLNEWS   = "URL:News 프로토콜"
URLFILE   = "URL:File 프로토콜"
THENET    = "Internet Explorer"
IDHTML    = "인터넷 문서 (HTML)"
AUSOUND   = "AU 형식 사운드"
AIFF      = "AIFF 형식 사운드"
XBM       = "XBM 이미지"
GIF       = "GIF 이미지"
JPEG      = "JPEG 이미지"
ISHORTCUT = "인터넷 바로 가기"

WWW_MSN_COM  = "http://www.msn.co.kr"
WWW_ALLINONE = "http://www.msn.co.kr"
