
[Strings]
KEY_OPTIONAL = "SOFTWARE\Microsoft\Windows\CurrentVersion\Setup\OptionalComponents"
@*:IJK = "Internet Jumpstart Kit"
@*:IE_TIP = "World Wide Web Internet Browser"
HISTORY = "history"
CACHE = "cache"
LONG_INET_PROGRAMS = "Program Files\Plus!\Microsoft Internet"
DOCS_DIR = "docs"
INET_DESC = "Kellékek\Internetes eszközök"
IEXPLORE_SHORT_DESC = "IEXPLORE"
IEXPLORE_DESC = "Internet Explorer"
URLHTTP = "URL:http protokoll"
URLHTTPS= "URL:http protokoll adatvédelemmel"
URLFTP  = "URL:ftp (fájlátviteli) protokoll"
URLTELNET = "URL:Telnet protokoll"
URLRLOGIN = "URL:RLogin protokoll"
URLTN3270 = "URL:TN3270 protokoll"
URLGOPHER = "URL:Gopher protokoll"
URLMAILTO = "URL:MailTo protokoll"
URLNEWS   = "URL:News protokoll"
URLFILE   = "URL:File protokoll"
THENET    = "Internet Explorer"
IDHTML    = "Internetes dokumentum (HTML)"
AUSOUND   = "AU formátumú hangfájl"
AIFF      = "AIFF formátumú hangfájl"
XBM       = "XBM kép"
GIF       = "GIF-kép"
JPEG      = "JPEG-kép"
ISHORTCUT = "Internetes parancsikon"

WWW_MSN_COM  = "http://www.msn.com"
WWW_ALLINONE = "http://www.hu.msn.com/access/allinone.htm"
