
[Strings]
KEY_OPTIONAL = "SOFTWARE\Microsoft\Windows\CurrentVersion\Setup\OptionalComponents"
@*:IJK = "Internet Jumpstart Kit"
@*:IE_TIP = "World Wide Web Internet Browser"
HISTORY = "Verlauf"
CACHE = "Cache"
LONG_INET_PROGRAMS = "Programme\Plus!\Microsoft Internet"
DOCS_DIR = "Dokumente"
INET_DESC = "Zubehör\Internet-Programme"
IEXPLORE_SHORT_DESC = "IEXPLORE"
IEXPLORE_DESC = "Internet Explorer"
URLHTTP = "URL:HTTP (HyperText Transfer Protocol)"
URLHTTPS= "URL:HTTPS (HyperText Transfer Protocol with Privacy)"
URLFTP  = "URL:FTP (File Transfer Protocol)"
URLTELNET = "URL:Telnet-Protokoll"
URLRLOGIN = "URL:RLogin-Protokoll"
URLTN3270 = "URL:TN3270-Protokoll"
URLGOPHER = "URL:Gopher-Protokoll"
URLMAILTO = "URL:MailTo-Protokoll"
URLNEWS   = "URL:News-Protokoll"
URLFILE   = "URL:Dateiprotokoll"
THENET    = "Internet Explorer"
IDHTML    = "Internet-Dokument (HTML)"
AUSOUND   = "AU-Audiodatei"
AIFF      = "AIFF-Audiodatei"
XBM       = "XBM-Bild"
GIF       = "GIF-Bild"
JPEG      = "JPEG-Bild"
ISHORTCUT = "Internet-Verknüpfung"

WWW_MSN_COM  = "http://www.de.msn.com"
WWW_ALLINONE = "http://msn.de/"
