
[Strings]
KEY_OPTIONAL = "SOFTWARE\Microsoft\Windows\CurrentVersion\Setup\OptionalComponents"
@*:IJK = "Internet Jumpstart Kit"
@*:IE_TIP = "World Wide Web Internet Browser"
HISTORY = "oversigt"
CACHE = "cache"
LONG_INET_PROGRAMS = "Programmer\Plus!\Microsoft Internet"
DOCS_DIR = "Dokumenter"
INET_DESC = "Tilbehør\Internetværktøjer"
IEXPLORE_SHORT_DESC = "IEXPLORE"
IEXPLORE_DESC = "Internet Explorer"
URLHTTP = "URL:HTTP"
URLHTTPS= "URL:HTTP med mulighed for beskyttelse af personlige oplysninger"
URLFTP  = "URL:FTP"
URLTELNET = "URL:Telnet"
URLRLOGIN = "URL:RLogin"
URLTN3270 = "URL:TN3270"
URLGOPHER = "URL:Gopher"
URLMAILTO = "URL:MailTo"
URLNEWS   = "URL:News"
URLFILE   = "URL:File"
THENET    = "Internet Explorer"
IDHTML    = "Internetdokument (HTML)"
AUSOUND   = "Lyd i AU-format"
AIFF      = "Lyd i AIFF-format"
XBM       = "XBM-billede"
GIF       = "GIF-billede"
JPEG      = "JPEG-billede"
ISHORTCUT = "Internetgenvej"

WWW_MSN_COM  = "http://www.msn.dk"
WWW_ALLINONE = "http://www.msn.com/access/allinone.htm"
