
[Strings]
KEY_OPTIONAL = "SOFTWARE\Microsoft\Windows\CurrentVersion\Setup\OptionalComponents"
@*:IJK = "Internet Jumpstart Kit"
@*:IE_TIP = "World Wide Web Internet Browser"
HISTORY = "Historial"
CACHE = "caché"
LONG_INET_PROGRAMS = "Archivos de programa\Plus!\Microsoft Internet"
DOCS_DIR = "documentos"
INET_DESC = "Accesorios\Herramientas de Internet"
IEXPLORE_SHORT_DESC = "IEXPLORE"
IEXPLORE_DESC = "Internet Explorer"
URLHTTP = "URL: protocolo de transferencia de hipertexto (HTTP)"
URLHTTPS= "URL: protocolo de transferencia de hipertexto con cifrado"
URLFTP  = "URL: protocolo de transferencia de archivos (FTP)"
URLTELNET = "URL: protocolo Telnet"
URLRLOGIN = "URL: protocolo RLogin"
URLTN3270 = "URL: protocolo TN3270"
URLGOPHER = "URL: protocolo Gopher"
URLMAILTO = "URL: protocolo de correo electrónico"
URLNEWS   = "URL: protocolo de noticias"
URLFILE   = "URL: protocolo File"
THENET    = "Internet Explorer"
IDHTML    = "Documento de Internet (HTML)"
AUSOUND   = "Sonido en formato AU"
AIFF      = "Sonido en formato AIFF"
XBM       = "Imagen XBM"
GIF       = "Imagen GIF"
JPEG      = "Imagen JPEG"
ISHORTCUT = "Internet Shortcut"

WWW_MSN_COM  = "http://www.microsoft.com/spanish/msn"
WWW_ALLINONE = "http://www.microsoft.com/spanish/access/allinone.htm"
