































;
; Localizable Strings
;
[Strings]
















































































W2Kcd="CD-ROM de Windows XP"
MS="Microsoft Windows XP"
PrinterClassName="Impresoras"
BrParWdm.SvcDesc="Controlador paralelo WDM de Brother"
PJL_MONITOR="Monitor de lenguaje PJL,PJLMON.DLL"
BJ_MONITOR="Monitor de lenguaje BJ,CNBJMON.DLL"
BJ_MONITOR2="Monitor de lenguaje BJ,CNBJMON2.DLL"
; Manufacturers
Agfa="Agfa"
Alps="Alps"
Apollo="Apollo"
Apple="Apple"
APS-PS="APS-PS"
AST="AST"
AT&T="AT&T"
Brother="Brother"
Bull="Bull"
C-Itoh="C-Itoh"
Canon="Canon"
Citizen="Citizen"
ColorAge="ColorAge"
Compaq="Compaq"
Dataproducts="Dataproducts"
Diconix="Diconix"
Digital="Digital"
Epson="EPSON"
Fujitsu="Fujitsu"
Fuji_Xerox="Fuji Xerox"
GCC="GCC"
Generic="Genérica"
Gestetner="Gestetner"
HP="HP"
IBM="IBM"
infotec="infotec"
Iwatsu="Iwatsu"
Kodak="Kodak"
Konica="Konica"
Kyocera="Kyocera Mita"
Lanier="Lanier"
LaserMaster="LaserMaster"
Lexmark="Lexmark"
Linotronic="Linotronic"
Mannesmann_Tally="Mannesmann Tally"
Microsoft="Microsoft"
Microtek="Microtek"
Minolta="Minolta"
MINOLTA-QMS="Minolta-QMS"
Monotype="Monotype"
NEC="NEC"
NRG="NRG"
Oce="Oce"
Oki="OKI"
Okidata="Okidata"
Olivetti="Olivetti"
Panasonic="Panasonic"
Printronix="Printronix"
QMS="QMS"
Quad="Quad"
Qume="Qume"
Radio_Shack="Radio Shack"
Ricoh="Ricoh"
Riso="Riso"
Royal="Royal"
Samsung="Samsung"
Savin="Savin"
Schlumberger="Schlumberger"
Scitex="Scitex"
Seiko="Seiko"
Seikosha="Seikosha"
Sharp="Sharp"
Shinko="Shinko"
Star="Star"
Tally="Tally"
Tandy="Tandy"
Tegra="Tegra"
Tektronix="Tektronix"
Texas_Instruments="Texas Instruments"
Toshiba="Toshiba"
Unisys="Unisys"
Varityper="Varityper"
Wang="Wang"
Wipro="Wipro ePeripherals"
Xante="Xante"
Xerox="Xerox"
