
[Strings]
KEY_OPTIONAL = "SOFTWARE\Microsoft\Windows\CurrentVersion\Setup\OptionalComponents"
@*:IJK = "Internet Jumpstart Kit"
@*:IE_TIP = "World Wide Web Internet Browser"
HISTORY = "history"
CACHE = "cache"
LONG_INET_PROGRAMS = "Program Files\Plus!\Microsoft Internet"
DOCS_DIR = "docs"
INET_DESC = "附件\Internet 工具"
IEXPLORE_SHORT_DESC = "IEXPLORE"
IEXPLORE_DESC = "Internet Explorer"
URLHTTP = "URL:超文本传送协议"
URLHTTPS= "URL:超文本传送协议(加密)"
URLFTP  = "URL:文件传送协议"
URLTELNET = "URL:Telnet 协议"
URLRLOGIN = "URL:RLogin 协议"
URLTN3270 = "URL:TN3270 协议"
URLGOPHER = "URL:Gopher 协议"
URLMAILTO = "URL:MailTo 协议"
URLNEWS   = "URL:News 协议"
URLFILE   = "URL:File 协议"
THENET    = "Internet Explorer"
IDHTML    = "Internet 文档 (HTML)"
AUSOUND   = "AU 格式音频文件"
AIFF      = "AIFF 格式音频文件"
XBM       = "XBM 图像"
GIF       = "GIF 图像"
JPEG      = "JPEG 图像"
ISHORTCUT = "Internet 快捷方式"

WWW_MSN_COM  = "http://www.msn.com"
WWW_ALLINONE = "http://www.msn.com/access/allinone.htm"
