
[Strings]
KEY_OPTIONAL = "SOFTWARE\Microsoft\Windows\CurrentVersion\Setup\OptionalComponents"
@*:IJK = "Internet Jumpstart Kit"
@*:IE_TIP = "World Wide Web Internet Browser"
HISTORY = "history"
CACHE = "cache"
LONG_INET_PROGRAMS = "Program Files\Plus!\Microsoft Internet"
DOCS_DIR = "docs"
INET_DESC = "附屬應用程式\網際網路工具"
IEXPLORE_SHORT_DESC = "IEXPLORE"
IEXPLORE_DESC = "Internet Explorer"
URLHTTP = "URL:HyperText 傳輸通訊協定"
URLHTTPS= "URL:HyperText 傳輸通訊協定附加保密"
URLFTP  = "URL:檔案傳輸通訊協定"
URLTELNET = "URL:Telnet 通訊協定"
URLRLOGIN = "URL:RLogin 通訊協定"
URLTN3270 = "URL:TN3270 通訊協定"
URLGOPHER = "URL:Gopher 通訊協定"
URLMAILTO = "URL:MailTo 通訊協定"
URLNEWS   = "URL:News 通訊協定"
URLFILE   = "URL:檔案通訊協定"
THENET    = "Internet Explorer"
IDHTML    = "網際網路文件 (HTML)"
AUSOUND   = "AU 格式音效"
AIFF      = "AIFF 格式音效"
XBM       = "XBM 影像"
GIF       = "GIF 影像"
JPEG      = "JPEG 影像"
ISHORTCUT = "網際網路捷徑"

WWW_MSN_COM  = "http://www.msn.com.tw"
WWW_ALLINONE = "http://www.msn.com/access/allinone.htm"
