
[Strings]
KEY_OPTIONAL = "SOFTWARE\Microsoft\Windows\CurrentVersion\Setup\OptionalComponents"
@*:IJK = "Internet Jumpstart Kit"
@*:IE_TIP = "World Wide Web Internet Browser"
HISTORY = "history"
CACHE = "cache"
LONG_INET_PROGRAMS = "Program Files\Plus!\Microsoft Internet"
DOCS_DIR = "docs"
INET_DESC = "עזרים\כלי אינטרנט"
IEXPLORE_SHORT_DESC = "IEXPLORE"
IEXPLORE_DESC = "Internet Explorer"
URLHTTP = "URL:פרוטוקול HyperText Transfer"
URLHTTPS= "URL:פרוטוקול HyperText Transfer עם פרטיות"
URLFTP  = "URL:פרוטוקול File Transfer"
URLTELNET = "URL:פרוטוקול Telnet"
URLRLOGIN = "URL:פרוטוקול RLogin"
URLTN3270 = "URL:פרוטוקול TN3270"
URLGOPHER = "URL:פרוטוקול Gopher"
URLMAILTO = "URL:פרוטוקול MailTo"
URLNEWS   = "URL:פרוטוקול קבוצות דיון"
URLFILE   = "URL:פרוטוקול קבצים"
THENET    = "Internet Explorer"
IDHTML    = "מסמך אינטרנט (HTML)"
AUSOUND   = "צליל בתבנית AU"
AIFF      = "צליל בתבנית AIFF"
XBM       = "תמונת XBM"
GIF       = "תמונת GIF"
JPEG      = "תמונת JPEG"
ISHORTCUT = "קיצור דרך לאינטרנט"

WWW_MSN_COM  = "http://www.msn.com"
WWW_ALLINONE = "http://www.msn.com/access/allinone.htm"
