
[Strings]
KEY_OPTIONAL = "SOFTWARE\Microsoft\Windows\CurrentVersion\Setup\OptionalComponents"
@*:IJK = "Internet Jumpstart Kit"
@*:IE_TIP = "World Wide Web Internet Browser"
HISTORY = "history"
CACHE = "cache"
LONG_INET_PROGRAMS = "Program Files\Plus!\Microsoft Internet"
DOCS_DIR = "docs"
INET_DESC = "アクセサリ\インターネット ツール"
IEXPLORE_SHORT_DESC = "IEXPLORE"
IEXPLORE_DESC = "Internet Explorer"
URLHTTP = "URL:ハイパーテキスト転送プロトコル"
URLHTTPS= "URL:ハイパーテキスト転送プロトコル (with Privacy)"
URLFTP  = "URL:ファイル転送プロトコル"
URLTELNET = "URL:Telnet プロトコル"
URLRLOGIN = "URL:RLogin プロトコル"
URLTN3270 = "URL:TN3270 プロトコル"
URLGOPHER = "URL:Gopher プロトコル"
URLMAILTO = "URL:MailTo プロトコル"
URLNEWS   = "URL:News プロトコル"
URLFILE   = "URL:File プロトコル"
THENET    = "Internet Explorer"
IDHTML    = "インターネット ドキュメント (HTML)"
AUSOUND   = "AU 形式サウンド"
AIFF      = "AIFF 形式サウンド"
XBM       = "XBM イメージ"
GIF       = "GIF イメージ"
JPEG      = "JPEG イメージ"
ISHORTCUT = "インターネット ショートカット"

WWW_MSN_COM  = "http://www.msn.co.jp/home.htm"
WWW_ALLINONE = "http://www.msn.com/access/allinone.htm"
