
[Strings]
KEY_OPTIONAL = "SOFTWARE\Microsoft\Windows\CurrentVersion\Setup\OptionalComponents"
@*:IJK = "Internet Jumpstart Kit"
@*:IE_TIP = "World Wide Web Internet Browser"
HISTORY = "historia"
CACHE = "Pamiêæ podrêczna"
LONG_INET_PROGRAMS = "Program Files\Plus!\Microsoft Internet"
DOCS_DIR = "Dokumenty"
INET_DESC = "Akcesoria\Narzêdzia internetowe"
IEXPLORE_SHORT_DESC = "IEXPLORE"
IEXPLORE_DESC = "Internet Explorer"
URLHTTP = "URL:Protokó³ HTTP"
URLHTTPS= "URL:Protokó³ HTTPS"
URLFTP  = "URL:Protokó³ FTP"
URLTELNET = "URL:Protokó³ Telnet"
URLRLOGIN = "URL:Protokó³ RLogin"
URLTN3270 = "URL:Protokó³ TN3270"
URLGOPHER = "URL:Protokó³ Gopher"
URLMAILTO = "URL:Protokó³ MailTo"
URLNEWS   = "URL:Protokó³ News"
URLFILE   = "URL:Protokó³ plikowy"
THENET    = "Internet Explorer"
IDHTML    = "Dokument internetowy (HTML)"
AUSOUND   = "DŸwiêk formatu AU"
AIFF      = "DŸwiêk formatu AIFF"
XBM       = "Obraz XBM"
GIF       = "Obraz GIF"
JPEG      = "Obraz JPEG"
ISHORTCUT = "Skrót internetowy"

WWW_MSN_COM  = "http://www.msn.com"
WWW_ALLINONE = "http://www.msn.com/access/allinone.htm"
