
[Strings]
KEY_OPTIONAL = "SOFTWARE\Microsoft\Windows\CurrentVersion\Setup\OptionalComponents"
@*:IJK = "Internet Jumpstart Kit"
@*:IE_TIP = "World Wide Web Internet Browser"
HISTORY = "Sivuhistoria"
CACHE = "cache"
LONG_INET_PROGRAMS = "Program Files\Plus!\Microsoft Internet"
DOCS_DIR = "docs"
INET_DESC = "Apuohjelmat\Internet-työkalut"
IEXPLORE_SHORT_DESC = "IEXPLORE"
IEXPLORE_DESC = "Internet Explorer"
URLHTTP = "URL:HTTP -protokolla"
URLHTTPS= "URL:HTTP -protokolla tietosuojalla"
URLFTP  = "URL:FTP -protokolla"
URLTELNET = "URL:Telnet -protokolla"
URLRLOGIN = "URL:RLogin -protokolla"
URLTN3270 = "URL:TN3270 -protokolla"
URLGOPHER = "URL:Gopher -protokolla"
URLMAILTO = "URL:MailTo -protokolla"
URLNEWS   = "URL:News -protokolla"
URLFILE   = "URL:File -protokolla"
THENET    = "Internet Explorer"
IDHTML    = "Internet-asiakirja (HTML)"
AUSOUND   = "AU-ääni"
AIFF      = "AIFF-ääni"
XBM       = "XBM-kuva"
GIF       = "GIF-kuva"
JPEG      = "JPEG-kuva"
ISHORTCUT = "Internet-pikakuvake"

WWW_MSN_COM  = "http://www.msn.fi"
WWW_ALLINONE = "http://search.msn.fi"
