
[Strings]
KEY_OPTIONAL = "SOFTWARE\Microsoft\Windows\CurrentVersion\Setup\OptionalComponents"
@*:IJK = "Internet Jumpstart Kit"
@*:IE_TIP = "World Wide Web Internet Browser"
HISTORY = "history"
CACHE = "cache"
LONG_INET_PROGRAMS = "Program Files\Plus!\Microsoft Internet"
DOCS_DIR = "docs"
INET_DESC = "Donatýlar\Internet Araçlarý"
IEXPLORE_SHORT_DESC = "IEXPLORE"
IEXPLORE_DESC = "Internet Explorer"
URLHTTP = "URL:HyperText Transfer Protocol"
URLHTTPS= "URL:HyperText Transfer Protocol with Privacy"
URLFTP  = "URL:File Transfer Protocol"
URLTELNET = "URL:Telnet Ýletiþim Kuralý"
URLRLOGIN = "URL:RLogin Ýletiþim Kuralý"
URLTN3270 = "URL:TN3270 Ýletiþim Kuralý"
URLGOPHER = "URL:Gopher Ýletiþim Kuralý"
URLMAILTO = "URL:MailTo Iletisim Kurali"
URLNEWS   = "URL:News Iletisim Kurali"
URLFILE   = "URL:File Iletisim Kurali"
THENET    = "Internet Explorer"
IDHTML    = "Internet Belgesi (HTML)"
AUSOUND   = "AU Biçimli Ses"
AIFF      = "AIFF Biçimli Ses"
XBM       = "XBM Resmi"
GIF       = "GIF Resmi"
JPEG      = "JPEG Resmi"
ISHORTCUT = "Internet Kýsayolu"

WWW_MSN_COM  = "http://www.msn.com"
WWW_ALLINONE = "http://www.msn.com/access/allinone.htm"
