
[Strings]
KEY_OPTIONAL = "SOFTWARE\Microsoft\Windows\CurrentVersion\Setup\OptionalComponents"
@*:IJK = "Internet Jumpstart Kit"
@*:IE_TIP = "World Wide Web Internet Browser"
HISTORY = "historique"
CACHE = "cache"
LONG_INET_PROGRAMS = "Program Files\Plus!\Microsoft Internet"
DOCS_DIR = "docs"
INET_DESC = "Accessoires\Outils Internet"
IEXPLORE_SHORT_DESC = "iexplore"
IEXPLORE_DESC = "Internet Explorer"
URLHTTP = "URL:Protocole HTTP"
URLHTTPS= "URL:Protocole HTTP avec confidentialité"
URLFTP  = "URL:Protocole FTP"
URLTELNET = "URL:Protocole Telnet"
URLRLOGIN = "URL:Protocole RLogin"
URLTN3270 = "URL:Protocole TN3270"
URLGOPHER = "URL:Protocole Gopher"
URLMAILTO = "URL:Protocole MailTo"
URLNEWS   = "URL:Protocole de News"
URLFILE   = "URL:Protocole de fichier"
THENET    = "Internet Explorer"
IDHTML    = "Document Internet (HTML)"
AUSOUND   = "Son au format AU"
AIFF      = "Son au format AIFF"
XBM       = "Image XBM"
GIF       = "Image GIF"
JPEG      = "Image JPEG"
ISHORTCUT = "Raccourci Internet"

WWW_MSN_COM  = "http://www.msn.fr"
WWW_ALLINONE = "http://www.msn.fr/access/allinone.htm"
