
[Strings]
KEY_OPTIONAL = "SOFTWARE\Microsoft\Windows\CurrentVersion\Setup\OptionalComponents"
@*:IJK = "Internet Jumpstart Kit"
@*:IE_TIP = "World Wide Web Internet Browser"
HISTORY = "Tidigare"
CACHE = "Cache"
LONG_INET_PROGRAMS = "Program\Plus!\Microsoft Internet"
DOCS_DIR = "docs"
INET_DESC = "Tillbehör\Internet-verktyg"
IEXPLORE_SHORT_DESC = "IEXPLORE"
IEXPLORE_DESC = "Internet Explorer"
URLHTTP = "URL:HTTP"
URLHTTPS= "URL:HTTP med sekretess"
URLFTP  = "URL:FTP"
URLTELNET = "URL:Telnet-protokoll"
URLRLOGIN = "URL:RLogin-protokoll"
URLTN3270 = "URL:TN3270-protokoll"
URLGOPHER = "URL:Gopher-protokoll"
URLMAILTO = "URL:MailTo-protokoll"
URLNEWS   = "URL:News-protokoll"
URLFILE   = "URL:File-protokoll"
THENET    = "Internet Explorer"
IDHTML    = "Internet-dokument (HTML)"
AUSOUND   = "Ljud i AU-format"
AIFF      = "Ljud i AIFF-format"
XBM       = "XBM-bild"
GIF       = "GIF-bild"
JPEG      = "JPEG-bild"
ISHORTCUT = "Internet-genväg"

WWW_MSN_COM  = "http://www.msn.se"
WWW_ALLINONE = "http://www.msn.se"
