
[Strings]
KEY_OPTIONAL = "SOFTWARE\Microsoft\Windows\CurrentVersion\Setup\OptionalComponents"
@*:IJK = "Internet Jumpstart Kit"
@*:IE_TIP = "World Wide Web Internet Browser"
HISTORY = "history"
CACHE = "cache"
LONG_INET_PROGRAMS = "Program Files\Plus!\Microsoft Internet"
DOCS_DIR = "docs"
INET_DESC = "Pøíslušenství\Nástroje Internetu"
IEXPLORE_SHORT_DESC = "IEXPLORE"
IEXPLORE_DESC = "Internet Explorer"
URLHTTP = "URL:Protokol http"
URLHTTPS= "URL:Protokol http se zabezpeèením"
URLFTP  = "URL:Protokol ftp"
URLTELNET = "URL:Protokol telnet"
URLRLOGIN = "URL:Protokol rlogin"
URLTN3270 = "URL:Protokol tn3270"
URLGOPHER = "URL:Protokol gopher"
URLMAILTO = "URL:Protokol mailto"
URLNEWS   = "URL:Protokol news"
URLFILE   = "URL:Protokol file"
THENET    = "Internet Explorer"
IDHTML    = "Dokument Internetu (HTML)"
AUSOUND   = "Zvuk formátu AU"
AIFF      = "Zvuk formátu AIFF"
XBM       = "Obrázek formátu XBM"
GIF       = "Obrázek formátu GIF"
JPEG      = "Obrázek formátu JPEG"
ISHORTCUT = "Zástupce internetové adresy"

WWW_MSN_COM  = "http://www.msn.cz"
WWW_ALLINONE = "http://www.msn.com/access/allinone.htm"
