
[Strings]
KEY_OPTIONAL = "SOFTWARE\Microsoft\Windows\CurrentVersion\Setup\OptionalComponents"
@*:IJK = "Internet Jumpstart Kit"
@*:IE_TIP = "World Wide Web Internet Browser"
HISTORY = "cronologia"
CACHE = "cache"
LONG_INET_PROGRAMS = "Programmi\Plus!\Microsoft Internet"
DOCS_DIR = "documenti"
INET_DESC = "Accessori\Accesso a Internet"
IEXPLORE_SHORT_DESC = "IEXPLORE"
IEXPLORE_DESC = "Internet Explorer"
URLHTTP = "URL:Protocollo di trasferimento HyperText"
URLHTTPS= "URL:Protocollo di trasferimento protetto HyperText"
URLFTP  = "URL:Protocollo di trasferimento file"
URLTELNET = "URL:Protocollo di trasferimento Telnet"
URLRLOGIN = "URL:Protocollo RLogin"
URLTN3270 = "URL:Protocollo TN3270"
URLGOPHER = "URL:Protocollo Gopher"
URLMAILTO = "URL:Protocollo MailTo"
URLNEWS   = "URL:Protocollo per News"
URLFILE   = "URL:Protocollo per File"
THENET    = "Internet Explorer"
IDHTML    = "Documento Internet (HTML)"
AUSOUND   = "Formato audio AU"
AIFF      = "Formato audio AIFF"
XBM       = "Immagine XBM"
GIF       = "Immagine GIF"
JPEG      = "Immagine JPEG"
ISHORTCUT = "Collegamento Internet"

WWW_MSN_COM  = "http://www.msn.it"
WWW_ALLINONE = "http://search.msn.it/"
