
[Strings]
KEY_OPTIONAL = "SOFTWARE\Microsoft\Windows\CurrentVersion\Setup\OptionalComponents"
@*:IJK = "Internet Jumpstart Kit"
@*:IE_TIP = "World Wide Web Internet Browser"
HISTORY = "geschiedenis"
CACHE = "cache"
LONG_INET_PROGRAMS = "Program Files\Plus!\Microsoft Internet"
DOCS_DIR = "docs"
INET_DESC = "Bureau-accessoires\Internet-werkset"
IEXPLORE_SHORT_DESC = "IEXPLORE"
IEXPLORE_DESC = "Internet Explorer"
URLHTTP = "URL:HyperText Transfer Protocol"
URLHTTPS= "URL:HyperText Transfer Protocol met geheimhouding"
URLFTP  = "URL:File Transfer Protocol"
URLTELNET = "URL:Telnet-protocol"
URLRLOGIN = "URL:RLogin-protocol"
URLTN3270 = "URL:TN3270-protocol"
URLGOPHER = "URL:Gopher-protocol"
URLMAILTO = "URL:MailTo-protocol"
URLNEWS   = "URL:News-protocol"
URLFILE   = "URL:File-protocol"
THENET    = "Internet Explorer"
IDHTML    = "Internet-document (HTML)"
AUSOUND   = "Geluid in AU-indeling"
AIFF      = "Geluid in AIFF-indeling"
XBM       = "XBM-afbeelding"
GIF       = "GIF-afbeelding"
JPEG      = "JPEG-afbeelding"
ISHORTCUT = "Internet-snelkoppeling"

WWW_MSN_COM  = "http://www.msn.nl"
WWW_ALLINONE = "http://www.msn.nl"
