
[Strings]
KEY_OPTIONAL = "SOFTWARE\Microsoft\Windows\CurrentVersion\Setup\OptionalComponents"
@*:IJK = "Internet Jumpstart Kit"
@*:IE_TIP = "World Wide Web Internet Browser"
HISTORY = "logg"
CACHE = "hurtigbuffer"
LONG_INET_PROGRAMS = "Programfiler\Plus!\Microsoft Internet"
DOCS_DIR = "docs"
INET_DESC = "Tilbehør\Internett-verktøy"
IEXPLORE_SHORT_DESC = "IEXPLORE"
IEXPLORE_DESC = "Internet Explorer"
URLHTTP = "URL- adresse: Protokoll for hypertekstoverføring"
URLHTTPS= "URL-adresse: HyperText Transfer Protocol, med fortrolighet"
URLFTP  = "URL-adresse: Protokoll for filoverføring"
URLTELNET = "URL-adresse: Telnet-protokoll"
URLRLOGIN = "URL-adresse: RLogin-protokoll"
URLTN3270 = "URL-adresse: TN3270-protokoll"
URLGOPHER = "URL-adresse: Gopher-protokoll"
URLMAILTO = "URL-adresse:MailTo-protokoll"
URLNEWS   = "URL-adresse:News-protokoll"
URLFILE   = "URL-adresse: Filprotokoll"
THENET    = "Internet Explorer"
IDHTML    = "Internett-dokument (HTML)"
AUSOUND   = "Lyd i AU-format"
AIFF      = "Lyd i AIFF-format"
XBM       = "XBM-bilde"
GIF       = "GIF-bilde"
JPEG      = "JPEG-bilde"
ISHORTCUT = "Internett-snarvei"

WWW_MSN_COM  = "http://www.msn.no/"
WWW_ALLINONE = "http://search.msn.no/"
